5,5
#####
#.#.#
#...#
##.##
#####
